NO ./texture/wall1.png
SO ./texture/wall2.png
WE ./texture/wall3.png
EA ./texture/wall4.png
F 30,30,50
C 0,100,220


1111111111111111111111111111
100000000000000000000001
110000000W00000000000001111
111000000000000000000001
111111111111111111111111111