NO ./texture/wall1.png
SO ./texture/gun.png
WE ./texture/wall3.png
EA ./texture/wall4.png
F 30,30,50
C 0,100,220


111111111111111111111111
100100000000000000000001
100000000000000000000001
100000000000000000000001
111111111111111111111111