NO ./path_to_the_north_texture
SO ./path_to_the_south_texture
WE ./path_to_the_west_texture
EA ./path_to_the_east_texture
F 30,30,50
C 0,100,220


111111111111111111111111
100100000000000000000001
100000000000000000000001
100000000000000000000001
100000000000000000000001
100000100010000000000001
100000100010000100010001
100000100010000000000001
100000110110000101010001
100000000000000000010001
100000000000000000010001
100000000000000000010001
100000111111111000010001
100000100000001000010001
111011101111101000010001
110000000010101000000001
111111111010101000010001
110100001010101000010001
110000101010101000010001
110101101000101000010001
110111111111101000010001
110000000000001000010001
111111111111111000010001
111111111111111111111111