111111111111111111111111
100300000000000000000001
100000000000000000000001
100000000000000000000001
100000000000000000000001
100000200020000000000001
100000200020000300030001
100000200020000000000001
100000220220000303010001
100000000000000000020001
100000000000000000030001
100000000000000000040001
100000444444444000030001
100000400000004000040001
144044404444404000030001
140000000040404000000001
144444444040404000030001
140400004040404000040001
140000404040404000040001
140404204000404000040001
140444444444404000030001
140000000000004000020001
144444444444444000010001
111111111111111111111111