
F 220,100,0
SO ./texture/wall2.png

EA ./texture/wall4.png
C    225,30,                    0


NO./texture/wall1.png
WE    ./texture/wall3.png
D ./texture/door.png



111111111111
100000000001
11011D110011
111000000011
11000W000001
111111111111