
F 220,100,0
SO ./texture/wall2.png

EA ./texture/wall4.png
C    225,30,                    0


NO./texture/wall1.png
WE    ./texture/wall3.png



111   111
101111101111
10000000000111
111110010N00001
    101 101111
    1001001
  11000111
  10001111
111001
10001
1011
 1
