
F 220,100,0
SO ./texture/wall2.png

EA ./texture/wall4.png
C    225,30,                    0


NO./texture/wall1.png
WE    ./texture/wall3.png





111100
10001
10111
10W01
10011
11111